approximately	xấp xỉ;
apéritif	a pê ri típ
arab block	Khối Ả Rập
araucaria	bách tán
archbishop (cao dai)	Phối Sư
archeology	bác cổ
archivist (cao dai)	Sĩ Tải
argue	biện thuyết
argue somebody out of doing	bàn lùi
argue to refuse (to do something)	bàn lùi
arhat	La Hán
armory	binh xưởng
arms	binh khí
army hero	supper
army ranks	binh ngũ
arrange	bày
arsenal	binh khố
arsenic	a sen
arts and crafts	bách nghệ
as if one’s life depended on it	bán sống bán chất
asbestos	a mi ăng
asia	Châu Á
asia minor	Tiểu Á
asian continent	Châu Á
asian-american	Mỹ vàng
assist	bang trợ
assistant district chief	bang biện
astonishingly	đáng ngạc nhiên
at first	lúc đầu
at midday	lúc giữa trưa
at night	ban đêm
at night-time	buổi tối
at the beginning	ban đầu
at the risk of one’s life	bán mạng
athens	Nhã Ðiển
atomic bomb	bom nguyên tử
atropine	a trô pin
attention!	a lô
attorney	biện lý
au revoir	Tạm biệt
aunt	bác gái
authoritarian	bá đạo
avaricious	bon chen
avoid	bán mặt
award	ban tặng
azure	biếc
babble	bi ba bi bô
babies	anh nhi
bacon	ba chỉ
bag	bao
bag of rice	bao gạo
balcony	bao lơn
ball	banh
ball-shaped cake	bánh bỏng
ballast	bao cát
ballet	ba lê
balloon	bong bóng
banana tree	ba tiêu
band	ban nhạc
bangkok	Vọng Các
banished	biệt sứ
bank for investment and development	Ngân Hàng Đầu Tư và Phát Triển
banner	biểu ngữ
bar sight	biể xích
bargain away	bán đổ bán tháo
bargain sale	bán hóa giá
barium	ba ri
barracks bag	bao quân trang
barrel	ba ren
barrier	ba ri e
barter	bán đổ bán tháo
basalt	ba zan
base	căn cứ
base plate	bàn đế
bat a thousand	bách phát bách trúng
bathroom	buồng tắm
baton	ba toong
battery	bin
battle-seasoned	bách chiến
bazaar	ba za
bazooka	ba đô ca
be an expert in	biết rành
be anxious	bàn hoàn
be defeated	bái xái
be familiar	am tường
be forced to	buộc phải
be made up of	bao gồm
be surrounded by	bao quanh
be very sad	buồn teo
be worried	bàn hoàn
beauty	anh hoa
become loose	buột
bed roll	bao ngủ
bed sack	bao ngủ
bedroom	buồng ngủ
beer and wine	bia rượu
beginning stage	ban sơ
being away of that	biết được điều đó
bel; skip	ben
bentonite	ben tô nít
benzene	ben zen
benzol	ben zen
besiege	bao vây
best selling	bán chạy nhất
bestow	ban tặng
betray one’s country	bán nước
bevel pinion	bánh khía hình nón
bilateral meeting	buổi họp song phương
billiards	bi di
bimonthly	hai tháng một lần
biscuit	bánh quy
bisexual	bán nam bán nữ
biting	buốt
biweekly publication	bán guyệt san
black american	Mỹ đen
black flag (rebels)	Cờ Đen
black glutinous rice cake	bánh gai
bladder	bong bóng
bleat (of a goat)	be be
blockade	bao vây
blood stained hand	bàn tay nhúng máu
blossom	Hoa
blustering bully	anh hùng rơm
board of directors	ban giám đốc
board of directors or trustees	ban quản trị
boast	ba hoa
bogie wheel	bio
bomb explosion	bom nổ
book in sanskrit	Phạn thư
book of prophesy (c. 1670)	Sấm Truyền Ca
book on military tactics	binh thư
border	biên giới
border guard	biên phòng
border region	biên cảnh
border security	an ninh biên giới
boring	buồn
botanical (garden)	bách thảo
bottom’s up!	Cạn bôi!
boudoir	buồng khuê
boundary	biên cương
bow in admiration	bái phục
bow one’s respect to (a king) from a distance	bái vọng
bower	buồng khuê
box of matches	bao diêm
brake (pedal)	bàn đạp thắng chân
brave	anh dũng
bread	bánh
bread and butter	bánh mì phết bơ
bread spread with butter	bánh mì phết bơ
break open; (2) to stew	bung
bright and cheerful	au
brilliance	anh hoa
british commonwealth	Liên Hiệp Anh
british embassy	Sứ Quán Anh
broaden	bành
bromine	brôm
brother and sister	anh em ruột
brother in law (husband’s oldest brother)	anh chồng
brother in law (wife’s older brother)	anh trai của vợ
brothers	anh em
brothers and sisters	anh em chị em
brothers by the same mother	bào huynh
brothers in law	anh em cột chèo
brown american	Mỹ nâu
bruce lee	Lý Tiểu Long
brush	bàn chải
bubble	bong bóng
bucket	ben
buddha	Phật
buddhism	Phật Giáo
buddhist (person)	Phật Tử
buddhist matters	Phật sự
buddhist nun	bà vãi
buddhist protection society	Tăng Đoàn Bảo Vệ Chánh Pháp
buddhist studies	Phạn học
buddhist trinity	Tam Bảo
budget subsidies	bao cấp
bugbear	ba bị
bull’s eye	bia bắn
bull’s eye; (3) beer	bia
bunkmate	bàn đồng ngũ
bureau	buồng giấy
bureaucracy	an liêu
burma	Miến Điện
burma (short for miến điện)	Miến
burst out	bung ra
bus	bu‎ýt
bushel	ang
bust	bán thân
butt	báng súng
butterfly	buớm
buttock	bàn tọa
cabin; (2) bunch; (3) [cl for (body) organs]	buồng
cage	buồng
cake	bánh ngọt
cake made of glutinous rice	bánh khúc
cake made of glutinous rice flour dipped in lye	bánh tro
cake made of sweet potato meal (mixed with rice flour)	bánh khoai
calamity; (4) to spread	biến
california	Cali
call on	bái kiến
calm	an lòng
cambodia	Cao Mên
cambodian	Cao Miên
cambodian; (2) to sleep; (3) cotton; (4) to be long	Miên
cambodia’s future is still very unstable	Tương lai Cam Bốt còn nhiều bấp bênh
canada	Gia Nã Đại
cancel	bác bỏ
cane	ba toong
cannon fodder	bia đỡ đạn
canteen	bi đông
cantharides	ban miêu
cao dai (a vietnamese religion)	Cao Đài
cao dai (vietnamese religion)	Cao Đài Giáo
cao dai pope	Hộ Pháp Cao Đài
cape of good hope	Mũi Hảo Vọng
capitulum	buồng hoa
car bomb	bom xe hơi
careless	ba toác
careless and fast	ba chớp ba nhoáng
case	bao
cassia grandis	and ginger
catharsis	ban miêu
catholic church	Giáo Hội Công Giáo
cedar	bách
censor cardinal (cao dai)	Chưởng Pháp
censorship board	ban kiểm duyệt
centenary	bách chu niên
centennial celebration	bách chu niên
centigrade	bách phân
central africa	Trung Phi
central america	Trung Mỹ
central asia	Trung Á
central bank	Ngân Hàng Trung Ương
central europe	Trung Âu
central vietnam	Trung Việt Nam
cerebral hemisphere	bán cầu não
ceremony	buổi lễ
chamber	buồng
chamber (of a gun)	buồng đạn
champa	Chiêm Thành
chancellor (cao dai)	Chưởng Ấn
change	biến ảo
change into	biến thành
change jobs	bay nhẩy
charge	buộc tội
chart	biểu
chaudoc	Châu Đốc
checkerboard	bàn cờ
checkpoint	biên ải
cheesecake	bánh kem
chemical bomb	bom hóa học
chemical security	an ninh hóa học
cherry	anh đào
chessboard	bàn cờ
chicken coop	bu gà
chieftain	anh chị
child	anh nhỉ
china	Trung Quốc
china lost to japan	Trung Quốc thua Nhật Bản
china shares a border with 14 countries	Trung Quốc chung biên cương với 14 quóc gia
chinese	Hán
chinese (language)	Hoa Ngữ
chinese character	Hán tụ
chinese communists	Trung Cộng
chinese press agency	Tân Hoa Xã
choppy sea	biển sôi động
christ	Ki Tô
christian	Cơ Đốc
christianity	Ki Tô Giáo
christopher columbus	Kha Luân Bố
chromatic scale	bán âm giai
chronicles	biên niên sử
chủ tịch (chairman	CT
circle	bao quanh
clarify	biện minh
classroom	buồng học
cleaning brush	bàn chải thông nòng
clear-sighted and able	anh minh
cling	bám
cling to	bám giữ
close (sibling-like) friend	anh em bạn
close by	bàng tiếp
close or intimate friend; to flatter	a mi
clothes brush	bàn chải quần áo
clutch	bám víu
coast guard	Lực lượng Tuần duyên
coat	bành tô
cochichina	Nam Kỳ
cock	buồi
coconut cake	bánh dừa
codonopsis	ba kích
coerce; (3) cypress	bách
collateral	bàng hệ
come off	bong
come on!; outward journey or trip	a lê
comfortable	an lòng
command	binh đoàn
commando	biệt kích
comment humorously or excitedly	bàn tán
commentary	bài vợ bình luận
commerce	Bộ Trưởng Thương Mại
commission	ban
committee	ban
communist china	Trung Cộng
communist vietnam	Việt Nam Cộng Sản
communist vietnamese	Việt Cộng
compatriot	anh em đồng bào
compel	bách
compelled (to do something); against one’s will	buộc lòng
compile; (4) edge	biên
compile; compilation	biên dịch
complicate matters	bày trò
composition	bài văn
comprise	bao gồm
comrades	anh em
con-son (island)	Côn Sơn
conceive (impractical things)	bày vẽ
concert	buổi hòa nhạc
concoct	bày mưu tính kế
concubine	bá vương
conditional sale	bán đợ
confectionary	bánh kẹo
conference table	bàn hội nghị
confucian	Khổng
confucian scholar	Nho giả
confucian scholars (collective)	Nho lâm
confucianism	Nho đạo
confucius	Khổng
confused	bàng hoàng
congratulate	ban khen
consecrate one’s baby to god	bán khoán
consecrated bread	bánh thánh
console	bàn điều khiển
constitutional court	Viện Bảo Hiến
container	ang
contemporary	Việt Nam cận đại
content	an phận
content with one’s poverty	an bần
content with one’s situation	an phận thủ thường
contour flying	bay vòng quanh
contradict	bác lời
convalesce	an dưỡng
conventional bomb	bom thường
conversant with	am thục
convert; variable; (3) catastrophe	biến
conveyance of property to another	bán đoạn
cook	anh bếp
cook (male)	anh nuôi
cook for a long time	bung
copy	biên chép
corporation	TCT
corsair	Tàu ô
cost	biểu phí
count	bá tước
counterpart	bày vai
country	bang
couple	biền
couplet	biền ngẫu
courageous	anh dũng
course)	bàng thính
court officials	bá quan
courthouse	biệt thự
cousin	anh họ
cousins	anh em họ
cover	bao hàm
covering; to envelope	bao bọc
crab	bay chếch ngang
cream cake	bánh kem
crisis	biến động
crisp shrimp pastry	bánh tôm
crock	ang
crook	ba que
crushed	be bét
cryptography	an ninh mật mã
cure-all	bách giải
current transformer	biến dòng điện
curry favor with	a
cutting	buốt
cylindrical glutinous rice cake	bánh tét
czechoslovakia	Tiệp Khắc
cộng hòa nhân dân trung hoa (people’s republic of china)	CNT
cộng hòa xã hội chủ nghĩa việt nam (the socialist republic of vietnam)	CXCV
cộng sản (communist)	CS
cộng sản việt nam (communist vietnam)	CSVN
cộng đồng việt nam	CĐVN
dangle	buông thõng
dark room	buồng tối
dash; (4) to gather; (5) to flatter	a
data security	an toàn dữ liệu
dawn	buổi bình minh
day before tết	ba mươi Tết
day-boarder	bán trú
dazed	bàng hoàng
dazzled	bàng hoàng
deal	buôn
death notice	ai tín
debate	biện bác
decide by discussion	bàn định
deck	boong tàu
deck (of a ship)	boong
decorate	bài trí
defecate	bài tiết
definitive sale	bán đoạn mại
deform	biến dạng
dejected	buồn tủi
delayed action bomb	bom nổ chậm
deliberate	bàn luận
demi-	bán
demonstrate	biểu lộ
demonstrate support	bày tỏ sự hậu thuẫn
demonstrate; (3) to say	biểu
department	ban
department of defense	Bộ Quốc Phòng
department of energy	Bộ Trưởng Năng Lượng
depressed	buồn phiền
desk	bàn học
despondent	buồn teo
detach	biệt phái
detached retina	bong võng mạc
detachment	biệt đội
develop	biến hóa
develop; change	biến chuyển
development	biến chuyển
dialectic	biện chứng pháp
dictatorial	bá đạo
differential pinion	bánh khía vi phân
dining room	buồng ăn
dining table	bàn ăn
director of the department of science and industry	Vụ trưởng Vụ Khoa học, Công nghệ
dirge	ai ca
disagreeing brothers	anh em bất hòa
disappear	bay biến
disappointed	buồn nản
disaster	biến
discern	biện biết
discomfort	buợc bội
discourse	biện thuyết
discriminate	biện biết
discuss	biện bác
discuss and organize	bàn soạn
disgrace	bán danh
dishonor	bán danh
dismal	buồn thảm
disorganized	ba lăng nhăng
dispense	ban phát
displacement	bài thủy lượng
displacement tonnage	bài thủy lượng nhẹ
display	biểu diễn
display; (7) means	bài
dispose	bài liệt
dispose troops in battle formation	bài binh bố trận
disseminate widely	bá cáo
dissertation	bài luận
dissolute; to release	buông thả
dissuade from	bàn ra
distinctly	biết rõ trắng đen
distinguished	anh tuấn
distortion	biến hình
distribute	biến
ditto	buộc lòng phải
do or carry out business	buôn bán
dolmen; rock-like	bàn thạch
domestic security	an ninh quốc nội
doubtful	bán tín bán nghi
drama	bi kịch
dramatic poem	bi khúc
drawing of a cake	bánh vẽ
drinks accompanied by female companionship	bia ôm
driver’s cab (of a vehicle)	buồng lái xe
drogue target	bia móc
drop down	bay xuống
drop some words curtly	buông xõng
drug dealing; to deal drugs	buôn bạch phiến
drug smuggling	buôn lậu ma túy
druggist; to dispense	bào chế
dubious	bán tín bán nghi
duffel bag	bao quần áo
dumbbell	an te
dumpling	bánh bao
dumpster	ben
during the day	ban ngày
during the night	ban đêm
duty	bàn giao chức vụ
earl	bá tước
early morning	ban mai
ease	an ủi
easter	Lễ Phục Sinh
easy	an nhàn
eat with and work with)	ba cùng
economic court	Tòa Kinh Tế
economic mean	biện pháp kinh tế
edit	biên soạn
editor	biên tập viên
editorial	bài xã luận
eec	Cộng Đồng Kinh Tế Âu Châu
eject; defecation	bài tiết
elder brother	anh
elder brother (by blood)	anh ruột
eldest brother	anh cả
electrical power regulation	Luật Điện lực
electricity regulatory authority of vietnam (erav)	Cục Điều tiết điện lực
elegance	anh hoa
elegant and clever	anh tú
elegant furniture	bàn nghế nhã
elegy	bi ca
elephant’s ear-shaped flat cake	bánh tai voi
elevation	biể xích
eliminate	bài trừ
elite soldier	binh sĩ tinh nhuệ
elite troops	binh sĩ tinh nhuệ
emblem	biểu tượng
embrace	bao quát
eminent	anh tuấn
empathize with; (3) dust	ai
enclose	bao
encode	biến chữ
encompass	bao quanh
encyclopedia	bách khoa từ điển
encyclopedic	bách khoa
engine-room	buồng máy
english literature	anh văn
enlightened or wise king	anh quân
envelope	bao thơ
epic	anh hùng ca
epidermis	biểu bì
epigraphy	bi ký học
epitaph	bi văn
equal	bày vai
erudite	bác học
erythema	ban đỏ
essay	bài luận
etc.)	ban hành
etc.); (2) sickle	a
eulogize	ai điếu
eulogy	bài điếu văn
europe	Châu Âu
european community	Cộng Đồng (Chung) Âu Châu
european continent	Châu Âu
european economic community	Cộng Đồng Kinh Tế Âu Châu
european union	Khối Cộng Đồng Chung Âu châu
evening	buổi tối
event	biến cố
event; half a day	buổi
events]; session	buổi
ever	bao nhiêu
every time	bao giờ
every two weeks	bán nguyệt san
everybody	ai cũng
everybody likes him	ai cũng ưa nó
everyone	ai nấy
everyone has to	ai cũng phải
everyone is going	ai cũng đi hết
everyone knows	ai cũng biết
everyone says	ai cũng cho
everyone wants to go	ai cũng muốn đi hết
evolve	biến hóa
exam	bài thi
examination paper	bài thi
examining body	ban giám khảo
exception	biệt lệ
exchange views on	bàn bạc
excretion	bài tiết
executive board	ban chấp hành
executive committee	ban chấp hành
exercise	bài tập
exhibit	bày
exile	an trí
exile; banishment	an trí
exiled	biệt xứ
expand	bành trướng
expel	bài tiết
experienced	am luyện
explanation	bác bỏ chuyện
explode (bomb)	bom nổ
expose	biện bạch
expression	biểu thức
extend	bành trướng
extend; (2) byte	bai
extremely sad	buồn teo
fade	bay màu
fairy (woman)	bà tiên
falling down	buông lơi
falun gong	Pháp Luân Công
father and mother	bác mẹ
father superior	Cha bề trên
father’s elder brother	bá phụ
father’s older brother; (2) wise	bác
father’s sister in law	bá mẫu
fattish	beo béo
fbi	Cơ Quan Điều Tra Liên Bang Hoa Kỳ
fda	Cục Quản Trị Lương Thực và Dược Phẩm
federal bureau of investigation	Cơ Quan Điều Tra Liên Bang Hoa Kỳ
federal reserve	Cục Dự trữ Liên bang
federation	Liên Bang Nga
feel like (doing something)	buồn rầu
feel sleepy	buồn ngủ
feeling a biting cold; sharp	buốt
feeling a rather biting cold	buôn buốt
feeling a rather sharp pain	buôn buốt
feeling a sharp pain	buốt
feeling dull	buồn hiu
fellow	anh chàng
fellow citizens	anh em đồng bào
fellow countryman	anh em đồng bào
fence	ba ri e
fetish	bái vật
fetishism	bái vật giáo
fetus	bào thai
fever with eruption	ban bạch
field bag	ba lô
field desk	bàn dã chiến
field kit	ba lô
fifth wheel	bánh thư nam
final sale	bán đoạn mại
fine allusion	bánh vẽ
fine dirt	ai
fine rice vermicelli	bánh hỏi
finland	Phần Lan
fire bomb	bom cháy
firm	an định
first cousin (son of parent’s older sibling)	anh con nhà bác
first cousins	anh em chú bác
fish pond	ao cá
fishpond	ao nuôi cá
fixed income	ba cọc ba đồng
flank protection	biên vệ
flank security	an toàn bên sườn
flight at lower altitude	bay thấp
flit about	bay nhởn nhơ
floating cake	bánh trôi
flowery	bay bướm
fluctuate	biến đổi
fluid flywheel	bánh treo dầu
fly across	bay qua
fly off	bay lên
fly very high	bay bổng
flywheel	bánh trớn
folk song	bài ca dao
follow	a dua
food and drug administration	Cục Quản Trị Lương Thực và Dược Phẩm
foot	bàm chân
football	bóng đá
for one’s life	bán sống bán chất
forced	buộc lòng
forces	binh đội
forecast	an bài
foreign minister	Bộ Trưởng Bộ Ngoại Giao
foreign secretary	Bộ Trưởng Ngoại Giao
foresail	buồm mũi
forlorn	buồn xo
form of address to a young man; (2) england	anh
formal relations	bang giao chính thức
former vietnam	Việt Nam ngày xưa
franchise	bán quyền
fraudulent	biển lận
free	buông thả
french	Tây
french (language)	Pháp ngữ
friends	anh chị em
from the beginning	ban đầu
front wheel	bánh trước
front wheel drive	bánh trước phát động
frontal security	an toàn mặt trước
frontier	biên thùy
frontier area	biên cảnh
frontier guard	biên phòng
frontier pass	biên ải
frowning	bàu bạu
fruits and cakes	bánh trái
fuck	khốn nạn
fuji	Phú Sĩ
fukien	Phúc Kiến
full	anh ách
functional chart	biểu đồ hoạt động
funeral oration	bài điếu văn
furnish (with)	ban cấp
furniture	bàn ghế
garrulous	ba lém
gas bomb	bom hơi ngạt
gate	ba ri e
gear	bánh khía
gear pinion	bánh khía hộp số
gelatin	a giao
general chang kai shek	Tướng Tưởng Giới Thạch
general inspector (cao dai)	Giám Đạo
general secretary of the communist party	Tổng Bí Thư đảng CSVN
generous	bao dung
geneva	Geneve
get loose	buột
get rid of (merchandise)	bán tháo
give	ban
give (a present)	biếu
give as a new year’s gift	bán mở hàng cho ai
giá trị gia tăng (value added tax	GTGT
giám quản	GM
giám đốc (director)	GĐ
gleaming	anh ánh
glibly	bai bải
glide	bán mẫu âm
glimmering	anh ánh
glistening	anh ách ánh
global petroleum commercial bank	Ngân hàng TMCP dầu khí toàn cầu
global times (a chinese daily newspaper)	Hoàn Cầu Thời Báo
global variable	biến toàn cục
gloomily sad	buồn thiu
gloomy	buồn rười rượi
glove	bao tay
glue	a giao
glutinous rice cake	bánh nếp
glutinous rice chupatty	bánh phồng
glutinous rice chupatty mixed with powdered shrimp	bánh phồng tôm
glutinous rice doughnut	bánh rán
glutinous rice dumpling	bánh giầy
go ahead!	a lê
go away	biến mất
go for a constitutional	bách bộ
go for a walk	bách bộ
go to unnecessary lengths	bày vẽ
god	Thượng Đế
goddess of anger	La Sát
good	anh em bạn
goodbye	Tạm biệt
government clerk	bang tá
grab	ben
grandmother	bà cố nội
grandmother; mrs. (form of address for a woman)	bà
grant	ban
grant a favor	ban ơn
graph	biểu đồ
grateful	biết ơn
graze	Ma Cao
greater path buddhism	Phật Giáo đại thừa
greece	Hy Lạp
greek	Hy Lạp
green	biếc
green rice cake	bánh cốm
green-colored pastry	bánh mảnh cộng
greet	bái chào
grief and joy	ai lạc
ground fault coefficient	Hệ số sự cố chạm đất
growl	bàu nhàu
grumble	bàu nhàu
gulf of thailand	Vịnh Thái Lan
guy	anh chàng
had i known (then one would have done something else)	biết thế
hades	Ngọc tuyền
hainan island	Hải Nam
haiphong	Hải Phòng
hairbrush	bàn chải tóc
half a century	bán thế
half a life	bán thế
half century	bán thế kỷ
half thickness	bán hậu tính
half time gear	bánh khía trục cam
half-brother	anh em dị bào
half-colony	bán thuộc địa
half-length	bán thân
half-life (of a radioactive element)	bán sinh
half-sibling	am em dị bào
half-sister	anh em dị bào
half-track	bán xích xa
hallowed memory (of a deceased person)	anh linh
hand	bàn tay
hand over	bàn giao
hang loosely	buông lơi
hanoi	Hà Nội
hanzi	Hán tụ
happening	biến cố
happiness with one’s occupation	an cư lạc nghiệp
happy	an phận
has miss lien arrived yet?	Cô Liên đến chưa?
hatch a plot	bày mưu tính kế
have	bao gồm
have experienced	biết mùi
have improper speech or conduct	ba toác
have one’s itch	buồn mình
having peace of mind	an lòng
having piece of mind	an tâm
hawaii	Hạ Uy Di
hawaiian guitar	Hạ uy cầm
hawk	bán rong
he	anh chàng
he always dresses elegantly	anh ta bao giờ cũng ăn mặt nền nã
he doesn’t have a temperature	Nó không sốt
he has come here	anh ta đến đây, nói là có việc
he is a man of very few words	anh ta ít lời lắm
he is very wicked	Nó ác lắm
he was arrested	Nó bị bắt rồi
he was sentenced to prison for three years	Nó bị kết án ba năm tù
head of a congregation	bang trưởng
health	an ninh
health resort	an dưỡng đường
heart-rending	bi đát
heavenly palace (cao dai)	Hiệp Thiên Đài
heavy-hearted	buồn lòng
hecatomb	bách sinh
hedge hopping	bay là là gần đất
hegemony	bá quyền
helical gear	bánh khía hình soắn ốc
hello1	xin chào 1.
help	bang trợ
hematosis	biến huyết sác
hemi-	bán
hemihedral	bán diện
hemimorph	bán hình
hemiplegia	bán thân bất toại
hemisphere	bán cầu
her	bà ta
herbarium	bách thảo tập
here lies ~ (on a gravestone)	Nơi đây an nghĩ
hermitage	am
hero	anh hào
hero of labor	anh hùng lao động
hero; heroic	anh hùng
heroes	anh hùng hào kiệt
heroic	anh dũng
heroic song	anh hùng ca
heroin dealer	bán xì ke
heroine	anh thư
he’ll probably be here soon	Chắc anh ấy sắp đến
hierarchy	ban thứ
him	anh chàng
hinayana (theravada) buddhism	Phật Giáo tiểu thừa
his anger has subsided	anh ấy đã ngớt giận
his change of mind came out of the blue	anh ta thay đổi ý kiến đột ngột
hispanic-american	Mỹ nâu
historian (cao dai)	Thừa Sử
historic event	biến cố lịch sử
hitler	Hítle
ho chi minh city (saigon)	Thành Hồ
hold on (a second)!	Khoan đã!
hold on to (a military position)	bám trụ
holland	Hòa Lan
holy bread	bánh thánh
holy day	an nhật
homework	bài tập
homework (assignment)	bài làm
hong kong	Hồng Kông
honorific title	bá hộ
host	bánh thánh
house of peers	Hội đồng Quý Tộc
house of representatives	Hạ Viện
hover	bay lượn
how about going to the thanh the (restaurant)?	Lại nhà hàng Thanh Thế đi !
how about you?	Còn ông thì sao?
how can i forget	Quên thế nào được
how come you’ll be gone so long?	Sao ông đi lâu vậy?
how come?	Sao vậy?
how far	bao xa
how many	bao nhiêu
how many times	bao nhiêu lần
how many years	bao nhiêu năm
how many years of age	bao nhiêu tuổi
how much	bao nhiêu
how much?	bao nả
how so?	Sao vậy?
how unfortunate!	Khổ chưa!
howdah	bành tượng
however long	bao lâu
however many	bao nhiêu
however much	bao nhiêu
how’s business these days?	Dạo này ông có phát tài không?
hue (city in vietnam)	Huế
hug; (5) to count; (6) cypress; (7) hegemony	bá
huge	bao la
humble oneself	bái
hydrogen bomb	bom khinh khí
hymn	bài ca
hội đồng quản trị	HĐQT
i haven’t seen you in a long time	Lâu rồi không gặp anh
i knew it (right away)	biết ngay mà
i will	anh sẽ
iaea	Cơ quan nguyên tử năng quốc tế
idle	biếng nhác
idler wheel	bánh truyền xích
idol	bái vật
idolatry	bái thần giáo
iea	Cơ quan năng lượng quốc tế
ill-mannered	ba toác
illusion	bào ảnh
imf	Quỹ Tiền Tệ Quốc Tế
imitate	a tòng
immense	bao la
important event	biến cố quan trọng
in announcements)	a lô
in broad daylight	ban ngày ban mặt
in one’s seat	an vị
in place	an vị
in the afternoon	ban chiều
in the daytime	ban ngày
in the evening	ban tối
in the evening-night	buổi tối
in the morning	buổi sáng
incendiary bomb	bom cháy
include	bao gồm
incombank	Ngân Hàng Thương Mại Quốc Tế
incriminate	buộc tội
independent	biệt lập
index	biểu chỉ dẫn
index; (2) to express	biểu
india	Thiên trúc
indian almond	bàng
indicate agreement	biểu đồng tinh
indicator	biểu số
individualistically heroic	anh hùng cá nhận
indo-pakistani	Hồi Ấn
indolent	biếng nhác
indonesia	Nam Dương
indusium	bao mô
industrial security	an ninh kỹ nghệ
infant	anh hài
infants	anh nhi
infringe	bá chiếm
initially; initial	ban đầu
inner mongolia	Nội Mông
instructor (cao dai)	Tiếp Dẫn Đạo Nhơn
instrument flying	bay nhờ khí cụ
insurrection	biến động
intelligent and handsome	anh tuấn
international atomic energy agency	Cơ quan nguyên tử năng quốc tế
international energy agency	Cơ quan năng lượng quốc tế
international monetary fund	Quỹ Tiền Tệ Quốc Tế
international relations	bang giao
international space station	Trạm Không Gian Quốc Tế
interrupter	anh te ruýp tơ
intimate with	am tường
inverted flight (of a plane)	bay lật úp
inverted flying	bay đảo ngược
investigative committee	ban điều tra
investigator (cao dai)	Truyền Trạng
iraq	I Rắc
iron (for clothes)	bàn ủi
iron curtain	Bức Màn Sắt
irregular	buổi đực buổi cái
islam	Hồi Giáo
islamic	Hồi
iso	Tổ Chức Tiêu Chuẩn Quốc Tế
isolated	biệt tịch
isolated; (2) to disappear	biệt
israel	Do Thái
it’s me	anh đây
ivory symbol of office (of a mandarin)	bài ngà
jacket	bành tô
japan	Nhựt
japan (literary)	Phù Tang
japanese	Nhật
japanese emperor	Nhật Hoàng
japanese industry standard (jis)	Tiêu Chuẩn Kỹ Nghệ Nhật Bản
japanese language or literature	Hòa văn
japanese studies	Hòa học
jelly (glue) made from antlers; megalossaur	ban long
jerusalem	Yêrusalem
jesus	Yêsu
jesus christ	Yêsu Kitô
john	Gioan
judaism	Do Thái giáo
jupiter	Mộc
just a little while ago	ban nẫy
just now	ban nãy
justice minister	Bộ Trưởng Tư Pháp
justify	biện minh
jute bag	bao tải
kansu	Cam Túc
kanto (region of japan)	Quan đông
key	bài giải
keyboard	bàn phím
khmer rouge	Khơ Me Đỏ
khoa học công nghẹ	KHCN
khoa học và kỹ thuật	KH&KT
kin	bà con
king of cambodia	Miên hoàng
kingdom	bá nghiệp
kiss up to; (6) area of 100 square meters	a
kit-bag	ba lô
kitchen god	Táo quân
knapsack	ba lô
kneecap	bánh chè
know a lot about	am hiểu
know ahead of time	biết trước
know for certain	biết đích xác
know how to do (something) be aware of	biết
know well	am tường
know what one did wrong	biết lỗi
knowing that	biết được điều đó
knowledge representation	biểu diễn tri thức
knowledgeable in	am thục
korea	Hàn Quốc
krakow	Cracốp
kremlin	Kremli
kwangtung	Quảng Đông
kyushu (region of japan)	Cửu Châu
lady’s man	anh chàng nịnh đầm
lafayette	La Phương
lament	ai ca
landing wheels	bánh hạ cánh
landlady	bà chủ nhà
landscape target	bia phong cảnh
laos	Lào
lateral	biên âm
lathe	bàn tiện
latin	La Tinh
latino-american	Mỹ nâu
lawyer (cao dai)	Cải Trạng
lazy	biếng
leadership council	ban chỉ đạo
leaflet bomb	bom truyền đơn
learned	bác lãm
learned; (3) to scramble (eggs); (4) cannon; (5) ample	bác
legislative affairs director (cao dai)	Hộ Pháp
leisurely	an nhàn
lenin	Lê Nin
leo	Hải sư
lesser path buddhism	Phật Giáo tiểu thừa
lesson	bài
let go	buông thả
let out	bung ra
let slip out	buột
letter bomb	bom thư
letter to the editor	bài vở
libra	Thiên xúng
libra (constellation)	Thiên bình
lift up	bay ra
lily	bách hợp
lily pond	bàu sen
limit	biên
literate	biết chữ
live in peace	an dật
living	biết đi
living room	buồng khách
liên hiệp quốc	LHQ
load recovery procedure	Trình tự phục hồi phụ tải
local security	an ninh sở tại
local variable	biến cục bộ
log	biên bản
london	Luân Đôn
long for	ao ước
long to	ao ước
loose	buông thả
loose hold	buột tay
loquacious	ba lém
lord	bá chủ
lose one’s prestige	bán danh
lotus pond	ao sen
louis	Lữ Y
lover	a măng
lovers	anh yến
lower	buông
lower the blind	buông mành
luminary	anh tài
luxembourg	Lục Xuâm Bảo
lời tòa soạn	LTS
mac-v (military assistance command - vietnam)	Phái Bộ Viện Trợ Quân Sự
macao or stroke lightly	Ma Cao
madam	bà lớn
magnanimous; to tolerate; tolerance	bao dung
mahayana buddhism	Phật Giáo đại thừa
maid	a hoàn
maidservant	a hoàn
mainland china	Trung Hoa lục địa
make a note (of something); (2) to weave (basket); (3) to edit	biên
make clear	bày tỏ
make or pay a visit	bái kiến
make or translate into vietnamese	Việt hóa
make public	bá cáo
make up a story	bày chuyện
make up medicines	bào chế
make yourself at home	anh cứ tự nhiên như ở nhà anh
malabar almond tree	bàng
malabar almond-shaped cake	bánh bàng
malay	Mã Lai
malaysia	Mã Lai Á
man of learning; learned	bác học
man of worth	anh hào
management	ban giám đốc
manchuria	Mãn Châu
mandarin chinese (language)	Quan thoại
maneuvering flight	bay thao dượt
manifest	biểu
manifest; revelation	biểu hiện
manila	Ma Ní
manor	biệt thự
many	bao
many diseases	bá bệnh
many schemes	bách kế
many trades	bách nghệ
many; (2) father’s older sibling; (3) to sow	bá
mao tse tung	Mao Trạch Đông
mare (lunar sea); (2) placard	biển
marijuana	anh túc
mars	Hỏa Tinh
martial; war	binh đao
marxist-leninist	Mác Lê Nin
master	bá chủ
matchmaker	bà mối
maternal grandmother	bà ngoại
maybe	biết đâu
meal	buổi cơm
meaningless	ba lăng nhăng
means	biện pháp
measles	ban đỏ
measure	biện pháp
measures	biện pháp cần thiết
medal of honor	Danh Dự Bội Tinh
medical doctor	bác sĩ
meditation hall (cao dai)	Trí Huệ Cung
medium	bà đồng
meeting	buổi họp mặt
meiji (emperor of japan)	Minh Trị
meiji restoration	Minh Trị Phục Hưng
melancholy	bi sầu
memorial	bài vị
mencius	Mạnh Tử
merchant	buôn thúng bán mẹt
messed up	ba rọi
metabolism	biến dưỡng
metamorphosis	biến hình
metaphase	biến kỳ
meter	biểu
method	biện pháp
mexico	Mễ Tây Cơ
mid-autumn festival pie	bánh trung thu
midday	ban trưa
midday-at noon	buổi trưa
middle east	Trung Đông
middle east region	Miền Trung đông
middleman; to act as a middleman or go-between	buôn nước bọt
midnight	bán dạ
midwife	bà đỡ
mikado	Thiên Hoàng
military	binh đao
military affairs	vấn đề quân sự
military career	Sự nghiệp quân sự
military doctrine	binh thuyết
military expenditures	binh phí
military man	binh gia
military manual	binh thư
military might	binh lực
military organization	binh chế
military power	binh quyền
military revolt	binh biến
military rights	binh quyền
military service	binh dịch
military supplies	binh nhu
military uniform	binh phục
military; (2) see bênh	binh
milk bread	bánh sữa
milk cake	bánh sữa
minister of education	Bộ Trưởng Giáo Dục
minister of foreign affairs	Bộ Trưởng Ngoại Vụ
ministry of agriculture	Bộ Nông Nghiệp
ministry of defense	Bộ Trưởng Quốc Phòng
ministry of domestic affairs	Bộ Nội Vụ
ministry of education and youth	Bộ Văn Hóa Giáo Dục và Thanh Niên
ministry of finance	Bộ Tài Chính
ministry of information	Bộ Thông Tin
ministry of justice justice department	Bộ Tư Pháp
ministry of national education	Bộ Quốc gia Giáo dục
ministry of public health	Bộ Y Tế
ministry of social welfare	Bộ Xã Hội
minutes	biên bản
misappropriate	biển thủ
misappropriate public funds	biển thủ công quỹ
miscellaneous	bác tạp
misfortune	ba đào
mitigate	an ủi
mixed up	bác tạp
mizzen (sail)	buồm câu
mizzen-sail	buồm lái
moderate islam	Hồi Giáo ôn hòa
modern-day vn	Việt Nam cận đại
modify	biến cải
modulation meter	biến điện kế
molasses-sweetened glutinous rice cake	bánh mật
monarch	anh quân
mongol	Thát Đát
mongolia	Mông Cổ
moon cake	bánh trung thu
morning	buổi sáng
morphine	a phiến trắng
moscow	Mạc Tư Khoa
mother	bà bô
mother in law	bà nhạc
mother-in-law	bà gia
mournful	bi thảm
mournful remembrance	ai hoài
moving	bi cảm
mr. bau	anh Báu
much	bao nả
muslim brotherhood	Huynh đệ Hồi giáo
mutation	biến chủng
mutiny	binh biến
mỹ kim	MK
narcotics	buôn lậu ma tuy
nation	bang gia
nation; (2) to help	bang
national bank (of vn)	Ngân Hàng Nhà Nước
national institute of health	Viện Sức Khỏe Quốc Gia
national mall (in washington dc)	Quảng trường Quốc gia
national rifle association	Hiệp Hội Súng Quốc Gia
national security	an ninh quốc gia
native american	Mỹ đỏ
nato	Khối Phòng Vệ Bắc Đại Tây Dương
natural sciences	bác vật học
nauseous	buồn mửa
nauseous; nausea	buồn nôn
naval security	an ninh hải quân
near	bàng (1) terminalia, a shade tree; (2)
near east	Cận Động
necessary means	biện pháp cần thiết
negative	bi quan
neighbor	bàng tiếp
neighboring	bàng tiếp
neptune	Hải vương tinh
new delphi	Tân Đề Li
new president	Tân tổng thống
new testament	Tân Ước
new year’s rice cake	bánh chưng
new york	Nữu Ước
new zealand	Tân Tây Lan
newspaper article	bài báo
newspaper articles]; (5) mandarin symbol of office; (6) to arrange	bài
next	bàng tiếp
nghị định chính phủ	NĐ-CP
nhân hàng nhà nước (national bank of vn)	NN
nickname	biệt hiệu
nine sphere palace (cao dai)	Cửu Trùng Đài
no one asked us	Không ai hỏi chúng tôi hết
no one came at all	Không ai đến dốt cả
noah	Nhữ Y
noise of gongs	beng beng
nom (old vietnamese writing system based on chinese characters)	Nôm
non-violent	biểu tình bất bạo động
noon	buổi trưa
noontime	ban trưa
north atlantic treaty organization	Khối Phòng Vệ Bắc Đại Tây Dương
north atlantic treaty organization (nato)	Tổ Chức Hiệp Ước Bắc Đại Tây Dương
norway	Na Uy
nose dive	bay bổ nhào
nose wheel	bánh trước phi cơ
not to mind	bao nài
not worried	an thân
not worried; assurance	an tâm
nothing at all like that!	Có mốc xì gì đâu!
now ~ now ~	ba hồi ~ ba hồi
nra	Hiệp Hội Súng Quốc Gia
nuclear bomb	bom nguyên tử
nuclear non-proliferation treaty	Hiệp định không phổ biến vũ khí hạch nhân
nuclear scientist	bác học nguyên tử
nullify	bác bỏ
obituary	ai tín
oblige; to tie up	buộc
observer	bàng quan
occident	Tây phương
occidental	Tây
occupational safety	an toàn lao động
occupations	bách nghệ
occurrence	biến cố quan trọng
ocean	biển cả
oceanus	biển cả
office	bàn giấy
office furniture	bàn ghế văn phòng
officialdom	an liêu
ogress	bà chằng
oh	Cha, mắc quá
old lady	bà già
old name for vietnam	Lạc Vịet
old testament	Cựu Ước
old woman	bà lão
older brother	bào huynh
oldest brother	anh cả
one earns a lot of extra money in that position	Làm chỗ ấy bở lắm
one’s father	bà cô
one’s predicament	biết thân
one’s status	biết thân
onlooker	bàng quan
open cubicles	buồng thoáng
open one’s mouth to speak	buông miệng
operating table	bàn mổ
ophiuchus	Thiên xà
opium	a phiến
opium set	bàn đèn
orchestra	ban nhạc
order	ban hành sắc luật
order; (4) second degree near relatives of different surnames; (5) memorial to the king	biểu
organization chart	biểu đồ tổ chức
organization for security and cooperation in europe (osce)	Tổ Chức An Ninh và Hợp Tác Âu Châu
origin	ban sơ
orphan	ai từ
ounce	ao xơ
outing (to have fun)	buổi đi chơi
outset	ban sơ
outside pin	bay soắn đảo ngược
outstanding man	anh kiệt
outstanding talent	anh tài
ovary	bào tử
overcoat	bành tô
overseas vietnamese	Việt kiều
pack	bao
pack of cigarettes	bao thuốc lá
package of cigarettes	bao thuốc
packaging	bao gói
pagoda	am tự
painful	bi khổ
pakistan	Hồi Quốc
palace	biệt điện
palace of wisdom (cao dai)	Thiên Hỉ Động
pali	Phạn ngữ
pali canons	Phạn điển
pancake	bánh kẹp
panther; scraggy; to pinch	beo
paper bag	bao giấy
paper target	bia giấy
papery thin water	bánh sữa
parallel constructions	biền ngẫu
parallel sentences	biền ngẫu
paramilitary	bán quân sự
paraphrase	biến cú
parent-teacher association	Hội phụ huynh học sinh
parents	ba xuân
parent’s cousin	bác họ
parent’s older brother	bác ruột
part	biệt ly
partially free	bán tự do
party	biệt toán
pass (laws	ban hành
pastry	bánh ngọt
pastry; (2) wheel	bánh
patella	bánh chè
paternal grandmother	bà nội
paternal grandmotherbà phước	sister (religious title): bà nội
pathetic	bi tráng
patrol	ba tui
paul (paulo)	Phao Lồi
peace	an hảo
peace and comfort or contentment	an lạc
peaceful	an tịnh
peaceful demonstration	biểu tình bất bạo động
peaceful life; tranquil	an hảo
pearl harbor	Trân Châu Cảng
pedal	bàn đạp
peddler	bán dạo
pediatrician	bác sĩ nhi
pellet; (3) sad	bi
peneplain	bán bình nguyên
peninsula	bán đảo
penname	biệt hiệu
penumbra	bán ảnh
people do whatever they want	ai muốn làm gì thì làm
people’s army (a newspaper)	Tờ Quân Đội Nhân Dân
percentage	bách phân suất
perform	biểu diễn
perhaps	biết đâu
perianth	bao hoa
pericardium	bao tâm
period	biến tướng
perplexed	bàng hoàng
persian gulf	Vịnh Ba Tư
person who has lost their mother	ai từ
personnel carrier	binh vận xa
pessimism	ai quan
pessimistic	bi quan
pete peterson	Pete Peterson thuộc đảng Dân Chủ
petition	biểu chương
pharmaceutics	bào chế học
pharmacy	bào chế học
phase	biến tướng
phenom penh	Nam Vang
phial	am pun
philanthropy	bác ái
philology	bác ngữ học
physical security	an ninh thực thể
phó giám đốc	P.GĐ
phó phòng	PP
pie	bánh
pigskin’s cake	bánh da lợn
pinion	bánh khía
pistol holster	bao súng lục
place	bài liệt
plain rice flan	bánh khoái
plaint	bi ca
plaintive	ai oán
plan	bàn tính
plane table	bàn họa
plane-table	bàn đạc
planning board	ban kế hoạch
plasterer’s hawk	bàn xoa
platform (of a machine)	bàn máy
playing-card	bài lá
plead	biện hộ
plead for	bào chữa
please give (us) your opinion	Xin ông cho biết ý kiến
please take a look	Xin ông cứ coi
pleura	bao phổi
plot	bày mưu tính kế
pneumatic tire	bánh hơi
poem	bài thơ
poetic	bay bướm
polished	bay bướm
polynia	ao băng
polytechnical	bách khoa
pond (in the fields)	bàu
pond and pool	ao chuôm
ponds and lakes	ao hồ
pool	bàu
pope (cao dai)	Giáo Tông
poppy	anh túc
post	Cục Bưu Điện
postmaster general	Tổng Giám Đốc Bưu Chính
potent; short-cut	bá đạo
powder bag	bao thuốc súng
powder room	buồng the
power	binh lực
practiced	am luyện
predestine	an bài
preordain	an bài
prepare medicines	bào chế
prescription	bài thuốc
presents	biện lễ
president)	CT
press conference	buổi họp báo
prick	buồi
primrose	anh thảo
private (as opposed to publicly funded)	bán công
private (military rank) (e1)	binh nhì
private (military rank) (e2)	binh nhất
problem	bài toán
procedure	biện pháp
process	biến chế
proclaim	bá cáo
produce	bao giàn
product safety	an toàn sản phẩm
promulgate (laws	ban bố
propaganda with troops	binh vân
prosecutor	biện lý
prosecutor’s office	biện lý cuộc
prostitution	mại dâm;
protect	bang
provide (with)	ban cấp
pseudonym	biệt hiệu
pta	Hội phụ huynh học sinh
public opinion	bia miệng
public welfare	an ninh công cộng
publicize	bá cáo
publish	ban hành
purpura	ban xuất huyết
put	bài liệt
put in solitary confinement	biệt giam
pyramidal rice dumpling	bánh giò
quarterdeck	boong sĩ quan
quartermaster’s corps	binh lương
queasy	buồn mửa
questionable	bán tín bán nghi
quiet	an tịnh
quintessence	anh hoa
radiation pattern	biểu đồ bức xạ
radiological security	an toàn phóng xạ
radius	bán kính
railing (on a balcony)	bao lơn
ranger	biệt kích
reasonable	biết điều
reassure) the population or people	an dân
rebellion	biến động
receipt	biên lai
receive an order respectfully	bái mạng
reckless	anh hùng chủ nghĩa
red american	Mỹ đỏ
red cross	Hội Hồng Thập Tự
red square (in moscow)	Trường Đỏ
reentrant	ao khúc tuyến
reentrant angle	ao giác
refined	bay bướm
reform	biến cách
regret	a
regulations)	ban bố
relations; to be related	bà con
relatives	bà con họ hàng
relaxed	an lòng
release	buông ra
religious affairs director (cao dai)	Thượng Phẩm
religious ceremony	buổi lễ tôn giáo
report	bài tường thuậ
reportedly on business	anh ta đến đây, nói là có việc
representation	biểu tượng
republican vietnam	Việt Nam Cộng Hòa
resourceful	biến báo
respect-paying audience	bái yết
rest home	an dưỡng đường
retail store; to sell at retail	bán lẻ
retailer	bán lẻ
retirement bureau	Sở Hưu Bổng
reveal	biểu hiện
revolt	biến loạn
rheostat	biến trở
rice cake	bánh tẻ
rice noodle	bánh phở
rice paper used for wrapping egg rolls	bánh tráng
rice pie	bánh giầy
rice spaghetti	bánh canh
rifle scabbard	bao súng
riot	biến loạn
ripple	ba
river god	Long Vương
roadside bomb	bom ven đường
rock-steady	bàn thạch
roll	bay quay tròn
rolling ball	bi xoay
rolling waves	ba đào
rolling-pin	bàn dát
roman	La Tinh
romanization	La Tinh hóa
rome	Roma
room and board	bao ăn ở
roommate	bàn đồng ngũ
rose-drop	ban hồng
rouge; ringleader	anh chị
roundtable	bàn tròn
rucksack	bao đeo lưng
rudder	bánh lái
ruler; to dominate	bá chủ
run	bay ngang
run-down	ba vạ
russia(n)	Nga
russian (federated) republic	Cộng Hòa Liên Bang Nga
russian federation	Liên bang Nga
russian president	Tổng thống Nga
ryuukyu	Lưu Cầu
sabbath	an nhật
sack	bào
sad	buồn tẻ
sad news (of a death)	ai tín
sadness and gladness	bi hoan
safe	an
safe and sound	an thân
safety	an ninh
safety area	an toàn khu
saga	anh hùng ca
saigon	Sài Gòn
saigon commercial bank	Ngân Hàng Thương Mại Cổ Phần Sài Gòn
sallowish	bung bủng
salute	bái chào
san francisco	Cựu Kim Sơn
sanatorium	an dưỡng đường
sand table	bàn cát
sandwich	bánh mì
sanskrit	Phạn ngữ
sanskrit studies	Phạn học
sash	bao tượng
satirize	biếm
satisfied with one’s (poor) fate	an bần
say	buông
scabbard	bao kiếm
scale	biểu
scapegoat	bung xung
scarlatina	ban đỏ
scarlet fever	ban đỏ
scatter bomb	bom mảnh
scholar	bác học
scholarly tradition	Nho phong
science and technology	KHĐT
scientist	bác học
scoundrel	ba que
scowling	bàu bạu
scraper	bàn nạo
screw-cutter	bàn ren
screw-wheel	bánh vít
sea	biển
sea of flames	biển lửa
seated	an vị
secluded	biệt tịch
secluded buddhist convent or temple	am mây
secluded hut	am
second world war	Trận Thế Chiến Thứ Nhất
secret	bem
secretariat	ban bí thư
secretary	Bộ Trưởng Quốc Phòng
secretary of state	Bộ Trưởng Bộ Ngoại Giao
secretary of trade	Bộ Trưởng Thương Mại
section; (2) unit of time; (3) to confer	ban
secular affairs director (cao dai)	Thượng Sanh
secure	an toàn
secure; (2) saddle	an
security	an ninh
security council	Hội Đồng Bảo An
security measures	biện pháp an ninh
security on the march	an toàn lúc di chuyền
security zone	an toàn khu
security; safe	an toàn
sedative	an thần
see bầu cử	bàu cử
self-indulgent	buông thả
sell at a loss or disadvantage	bán lỗ
sell at cost	bán vốn
sell by auction	bán đấu giá
sell cheaply or on the cheap	bán rẻ
sell for a clearance	bán xon
sell oneself	bán dâm
sell out	bán tháo
sell wholesale	bán cất
sell with the right of redeeming pawn	bán độ
semester	bán niên
semi-	bán
semi-automatic	bán tự động
semi-autonomous	bán tự trị
semi-colony	bán thuộc địa
semi-consciousness	bán ý thức
semi-consonant	bán phụ âm
semi-feudal	bán phong kiến
semi-finished product	bán thành phẩm
semi-free	bán tự do
semi-mobile	bán lưu động
semi-official	bán công khai
semi-public	bán công khai
semi-skilled	bán chuyên
semicircular	bán nguyệt
semiconductor	bán dẫn
semicyclic	bán hoàn
semiofficial	bán chính thức
semipolar	bán cực
semitone	bán âm
semivowel	bán mẫu âm
seoul	Hán Thành
separate	biệt lập
separated; separation	biệt ly
separation	biệt cư
sermon	bài diền văn
serpentarius	Thiên xà
servant	a hoàn
service	binh sở
service number	binh số
serviceman	binh sĩ
session	buổi họp mặt
set	bài liệt
set out	bày hàng
set up	bày
several	ba bảy
shack	am
shanghai	Thượng Hải
she	bà ấy
sheet music	bài đàn
shield	bao che
shikoku (region of japan)	Tứ Quốc
shinto	Thần đạo
shoebrush	bàn chải giầy
show	biểu diễn
show of force	biểu dương lực lượng
showa restoration	Thái Hòa Phục Hưng
shrike	bách thanh
siam	Xiêm
siberia	Tây Bá Lợi á
sibling	anh em ruột
siblings	anh em
sign	biểu ngữ
sign; (3) miserly	biển
silhouette target	bia hình
simplified chinese (characters)	Trung Hoa đơn giản
singapore	Tân Gia Ba
sino-vietnamese	Hoa Việt
sinus medii	Lõm Giũa
sinus roris	Lõm Sương
sitting	an tọa
slab	bia
slave trade; to trade in slaves	buôn người
sleep like a log; sound (of sleep)	an giấc
sleeping bag	bao ngủ
sleepy	buồn ngũ
sleeve; to cover	bao
slip	buột tay
slip of the tongue	buột miêng
slush brush	bàn chải chùi dầu
small cylindrical glutinous rice cake	bánh tày
small pagoda	am
small temple	am tự
small vendor	buôn thúng bán mẹt
small wine bottle; (2) to bleat	be
smallish	be bé
smeared	be bét
snow-flaked cake (sprinkled with powdered sugar)	bánh in
so many	biết mấy
so many times	bao nhiêu lần
so many years	bao nhiêu năm
so much	biết mấy
soar	bay liệng
social security	an ninh xã hội bắt đầu
social security office	Nha An Ninh Xã Hội Bắt Đầu
solace	an ủi
solar system	Thai Dương Hệ
solders and horses; army	binh mã
soldier	binh gia
soldiers	binh lính
solider	binh sĩ
solitary room (of a widow or a single young girl)	buồng không
solution	bài giải
some	bao
someone	ai
someone else	ai khác
somewhat proficient	bán chuyên
song	bài ca
sorceress	bà đồng
sorrowful	buồn rầu
sound encoding	biên mã âm thanh
sound of a bell ringing	boong boong
south africa	Nam Phi
south america	Nam Mỹ
south korea	Nam Triều Tiên
south pole	Nam Cực
south vietnamese pajamas	bà ba
southern california	Nam Cali
soviet	Sô Viết
soviet russia	Nga Sô
soviet union	Liên Bang Xô Viết
spain	Tây Ban Nha
spanish	Tây Ban Nha
spare	buông tha
spare tire	bánh sơ cua
spark-plug	bu gi
special	biệt tài
special district	biệt khu
special forces	biệt đội
special mobile troops	biệt động đội
special treatment	biệt đãi
specificity	biệt tính
spectator	bàng quan
speech	bài diền văn
spike-board	bàn chông
sponge cake	bánh bông lan
sporangium	bào tử nang
spore	bào tử
spore case	bào tử nang
sporocyst	bào tử phòng
sporophyll	bào tử diệp
sporophyte	bào tử thực vật
sporoplasm	bào tử chất
spread	bành trướng
spread; (4) to embrace	bá
stable	an định
stage	biến tướng
stagnant pond	ao tù
stained	be bét
stand for	biểu tượng
state	bang gia
statistical table	biểu thống kê
statoscope	biến áp kế
steering wheel	bánh lái
steering wheel (of a car)	bánh trước của xe
stele	bi ký
stele; (2) marble (toy)	bi
stele; (2) target	bia
stick	ba toong
sticky rice cake	bánh dẻo
stillness	an hảo
stingy	bo xiết
stock of a rifle	báng súng
stomach	bao tử
stone	bia
stone slab	bi ký
stooge	bung xung
strange development	biến chuyển lạ lùng
strategy	binh cơ
street vendor	bán dạo
street vendor; to peddle	bán rong
strength	binh lực
student of confucianism	Nho sinh
study	buồng giấy
study room	buồng học
stunned	bàng hoàng
style using couplets	biền văn
subacute	bán cấp
subdignitaries (cao dai)	Chức Việc
suffer or sustain a defeat	bái xái
sun	Thai Dương
superficial	biểu diện
superhuman strength	ba đầu sáu tay
supply (with)	ban cấp
supreme court	Tối Cao Pháp Viện
surround	bao vây
suspension wheel	bánh treo
swallow sail	buồm én
sweden	Thụy điển
sweet meat pie in lumps	bánh chả
sweet roll	bánh ngọt
sweet short cake (made of roast glutinous rice flour)	bánh khảo
sweetheart	a măng
swiss	Thụy Sĩ
switzerland	Thụy Sĩ
symbol	biểu tượng
symbolize; representative	biểu tượng
sympathize	ai
syngman rhee	Lý Thừa Vãn
szechuan	Tứ Xuyên
tables and chairs	bàn ghế
tactical navigation	bay chiến thuật
tactics	binh pháp
tae kwon do	Thái Cực Đạo
take a hint	biết ‎ ý
take it easy	Cứ từ từ
talented man	an tài
talk nonsense	bá láp
talk over	bàn bạc
talk over; (2) table; (3) [cl for games]	bàn
talk somebody out of doing something	bàn ra
talkative	ba lém
tan son nhat (airport)	Tân Sơn Nhất
target	bia bắn
tartar	Thát Đát
task	bài làm
tax office	Sở Thuế Vụ
teammates	anh em trong tổ
telephone	Cục Bưu Điện
tell	biểu
temple in the clouds	am mây
temple; cottage	am
test	bài thi
test bench	bàn thử
test flight	bay thử
text	bài văn
thai	Thái
thailand	Xiêm
thankful	biết ơn
thanksgiving (american holiday)	Lễ Tạ Ơn
that evening	buổi tối hôm đó
that motor uses kerosene	Máy này chạy bằng dầu tây
that’s a lot you’re asking for	bà nói thách quá
that’s too expensive!	Cha, mắc quá
the (world) olympic games	Thế Vận Hội
the almighty	Thượng Đế
the ancient name of hanoi	Long Biên
the arab league	Liên đoàn Ả Rập
the axis alliance	Khối Trục
the bible	Kinh Thánh
the birthday of buddha	Phật Đản
the classic of filial piety	Hiếu kinh
the common people	bách tính
the delta	Lục Tỉnh
the evening before	buổi tối hôm trước
the fairy and the dragon (ancestors of the vietnamese race)	Tiên Rồng
the golden temple	Ngôi đền Vàng Kinkaku-gi
the greater east asia conference	Hội Nghị đại đông Á
the greater east asia coprosperity sphere	Khối Thịnh Vượng Chung Đại Đông Á
the greater east asia ministry	Bộ Đại Đông Á
the international standards organization	Tổ Chức Tiêu Chuẩn Quốc Tế
the jade emperor	Nhọc Hoàng
the korean peninsula	bán đảo Cao Ly
the league of nations	Hội Quốc Liên
the library of congress	Thư Viện Quốc Hội Hoa Kỳ
the lion	Hải sư
the masses	bách tính
the math problem was child’s play	bài toán làm như chơi
the middle ages	Trung Cổ
the milky way	Dải Ngân hà
the ministry of international trade and industry (miti)	﻿Bộ Ngoại Thương và Kỹ Nghệ
the netherlands; dutch	Hà Lan
the next morning	buổi sáng hôm sau
the officials	bách quan
the old lady is a little hard of hearing	bà cụ hơi nghểnh ngãng
the pacific ocean	Thái Bình Dương
the people	bá tánh
the philippines; filipino	Phi Luật Tân
the polish president became a puppet of russia	Tổng Thống Ba Lan đã làm bù nhìn chi Ngã
the population	bá tánh
the previous evening	buổi tối hôm trước
the promised land	Miên Đất Hứa
the red cross	Chữ Thập Đỏ
the redemptorists	Dòng Chúa Cứu Thế
the republic of vietnam	Việt Nam Cộng Hòa
the russian federation is only a shadow of the former soviet union	Liên Bang Nga là một vang bóng của Liên Xô ngày xưa
the russian union	Liên Bang Nga
the savior	Chúa cứu thế
the second	Mồng hai
the socialist republic of vietnam	Cộng Hòa Xã Hội Chủ Nghĩa Việt Nam
the spacious seas	biển mênh mông
the tale of kieu (by nguyễn du)	Truyện Kiều
the three branches of the armed forces	ba quân
the three “with’s” (live with	ba cùng
the tomb of the unknown solider	Mộ Chiến Sĩ Vô Danh
the west	Tây phương
the white house	Tòa Bạch Ốc
the wright brothers	anh em nhà Wright
theater group	ban hát
theater troupe	ban kịch
theatrical group	ban kịch
theatrical performance	buồi hát
theme	bài làm
theoretical graph	biểu đồ lý thuyết
there is no life on the moon	Không có sự sống trên Trăng
there is nothing at all	Chả có gì sốt
the‎‎y’ve rented them all already	Họ muốn hết rồi
thirty	ba chục
this afternoon	buổi chiều nay
this morning	ban sáng
thorax	buồng ngực
three autumns	ba thu
three days later	ba ngày sau
three deaths	ba ca tử vong
three dots	ba chấm
three or four	ba bốn
three or four times	ba bốn lần
three phase	ba pha
three resolves (in emulation movement)	ba quyết tâm
three responsibilities (women’s emulation movement)	ba đảm đang
three rounds of serving wine or burning incense	ba tuần
three silences	ba không
three spearhead-attack	ba mũi giáp công
three times	ba lần
three years	ba thu
three-fourths	ba phần tư
three-leaf clover	ba gạc
three-month growth rice	ba giăng
thành phố hồ chí minh	TPHCM
thủ tướng	TT
tiananmen	Thiên An Môn
tibet	Tây Tạng
tibetan	Tang
tibetan buddhism	Lạt Ma Giáo
tien tsin	Thiên Tân
time bomb	bom nổ chậm
tire	bánh xe
to	bán tống bán tháo
to (cause to) root	bám rễ
to accuse	buộc tội
to acidify	a cít hóa
to acknowledge receipt	biên nhận
to admire	bái phục
to aid	bang trợ
to annotate	biên chú
to answer respectfully	bái đáp
to ape	a dua
to argue	biện bác
to arrange	an bài
to array troops	bài binh bố trận
to auction	bán đấu giá
to audit (class	bàng thính
to banish	an trí
to be a hawker	bán bưng
to be a peddler or hawker	buôn gánh bán bưng
to be a prostitute	buôn son bán phấn
to be bored to death	buồn như chấu cắn
to be close by	bàng cận
to be next to	bàng (1) terminalia, a shade tree; (2)
to be obliged	buộc lòng
to be opposed to	bài xích
to be well versed	am thục
to become	biến thành
to become loose	bong
to besiege	bay vây
to bestow favors	ban ơn
to bless	ban phước
to bow	bái
to bow to one’s ancestors	bái tổ
to brag	ba hoa
to broadcast	bá âm
to build a bridge	bác cầu
to burst forth	bung ra
to bury	an táng
to calm (quiet	an dân
to change	biến đổi
to change; change	biến thiên
to characterize	biệu tính
to cheat in commerce	buôn gian bán lận
to circle (of an airplane)	bay quần
to clearly show	biện bạch
to cling to	bám riết
to cling to power	bám giữ quyền lực
to comfort	an ủi
to comfort oneself	an ủi mình
to comfort the victims	an ủi nạn nhân
to compile	biên soạn
to consist of	bao gồm
to contain	bao quát
to contrive (unnecessary things)	bày vẽ
to correct	biện chính
to cover	bao trùm
to cover up	bao phủ
to crave	ao ước
to create (unnecessary things)	bày đặt
to create unnecessary work	bày việc
to criticize	bác bẻ
to cut (off)	beng
to cut the neck of	beng cổ
to deal drugs	buôn bán ma túy
to deal heroin	buôn bán bạch phiến
to deal in foreign currencies	buôn bạc
to debate	bàn bạc
to decide (by a vote)	biểu quyết
to defend	bào chữa
to demonstrate against the government	biểu tình phản đối nhà nước
to demonstrate; demonstration	biểu tình
to detail	biệt phái
to detain separately	biệt giam
to develop	bành trướng
to disappear	biến đi
to disappear completely	biến đi mất hết
to discuss	bài cãi
to discuss (sth)	bàn về
to discuss and argue	bàn tán
to discuss and arrange	bàn soạn
to discuss sth	bàn chuyện về
to discuss the diplomatic situation	bàn luận tình trạng ngoại giao
to discuss without coming to any conclusion	bàn quanh
to disengage	buông tha
to display	biểu dương
to distinguish	biện biết
to distribute	ban phát
to do business wholesale	buôn cất
to drop one’s arms	buông tay
to drop some sharp words	buông xõng
to dump goods	bán phá giá
to edit	biên tập
to embezzle	biển thủ
to encircle	bao vây
to encode; encoding	biên mã
to encrypt	biến chữ
to enjoy (peacefully)	an hưởng
to evaporate	bay hơi
to excrete	bài xuất
to exhibit	biểu diễn
to expand	bành
to explain	biện minh
to express	biểu thị
to express concern	bày tỏ sự lo ngại
to express one’s ideas	bày tỏ ý kiến
to extend one’s influence	bành trướng ảnh hương
to fancy	ai đời
to feel sick; queasy	buồn nôn
to fly	bay lượn
to fly all about	bay nhởn nhơ
to fly around the moon	bay vòng quanh Mặt Trăng
to fly away	bay lên
to fly by	bay qua
to fly down	bay xuống
to fly into	bay vào
to fly to	bay chuyền
to fly very low	bay la
to follow	a tòng
to follow close or hard on somebody’s heels	bám sát
to force	buộc
to furnish	bài trí
to gamble	bài bạc
to get rid of	bài trừ
to give gifts frequently	biếu xén
to go for a stroll	bách bộ
to grant	ban tặng
to grant a boon	ban ơn mưa móc
to grieve and resent; grief and resentment	ai oán
to guard jealously	bo bo
to hang on	bám víu
to hang on to	bám
to hang onto	bám giữ
to have a desire to do something	buồn mình
to have a wide knowledge (of things past and present)	bác cổ thông kim
to have one’s head cut off	beng mất đầu
to have tasted	biết mùi
to have to	buộc phải
to hit one hundred percent	bách phát bách trúng
to hold private discussions	bàn mảnh
to hotly debate	bàn cãi sôi nổi
to hug	bá cổ
to issue	ban bố
to issue a decree	ban hành sắc luật
to issue a law	ban bố luật pháp
to know	biết
to know about	biết về
to know beforehead	biết trước
to know clearly	biết rõ
to know everything about	biết hết về
to know everything about sth	biết hết mọi thứ về
to know for sure	biết đích xác
to know how to use	biết dùng
to know how to use a weapon	biết cách sử dụng súng
to know it but to be forced to keep silence	biết đấy mà phải ngậm tăm
to know more about	biết nhiều hơn về
to know one thing for sure	biết chắc một điều
to know one's place	biết thân biết phận
to know oneself	biết thân
to know one’s mistakes	biết lỗi
to know one’s ways about in a city	biết hết ngõ ngách một thành phố
to know something inside and out	am hiểu cặn kẽ về gì
to know that	biết rằng
to know the value	biết giá trị
to know thoroughly	am tường
to know very clearly	biết rõ trắng đen
to know very well	biết rành
to know well	am hiểu
to learn a lesson by heart	bài học thuộc lòng
to leave in peace	an cư
to leave one’s native country (for good)	bán xới
to let (something) run its course	buông xuôi
to let a cup slip down from one’s hand	buột tay đánh rơi cái chén
to let out	buông ra
to let slip down	buột
to lie	bá láp
to live a leisurely life	an dật
to live in peace	an cư lạc nghiệp
to live together 100 years (set expression said to newlyweds)	bách niên giai lão
to make a slip of the tongue	buột miệng
to make clear one’s feeling	bày tỏ nỗi lòng
to make offerings	biện lễ
to make the first sale of the day	bán mở hàng cho ai
to manifest	biểu lộ
to modulate	biến điện
to move around	bay nhẩy
to not eat properly	biếng ăn
to not leave any traces	biệt tích
to not mind (hardship)	bao quản
to note down	biên chác
to offer (as a gift)	biếu
to offer for sale	bày bán
to organize	bao giàn
to outflank	bao sườn
to overshoot	bay quá mục tiêu
to pacify the border	an biên
to pacify the country	an bang
to pass a law	ban hành luật
to pass one’s old age peacefully	an hưởng tuổi già
to pay homage (to the dead)	ai điếu
to pinch someone’s cheek	beo má
to praise	ban khen
to press	bàn ép
to protect	bao yểm
to publish (research)	biên khảo
to pull out	bay ra
to realize	biết ‎ ý
to realize someone’s power	biết tay
to receive a gift (from someone above oneself)	bái lĩnh
to refuse	bác lời
to reject	bác bỏ
to reject (a request)	bác dơn
to reject a request	bác bỏ một thỉnh cầu
to reject a story	bác bỏ chuyện
to reject a theory	bác bỏ giả thiết
to reject a verdict	bác án
to reject an accusation	bác bỏ tố cáo
to reject criticisms	bác bỏ những chỉ trích
to release	buông
to represent	biểu tượng
to resell	bán lại
to rest	an tức
to rest (to regain one’s health)	an dưỡng
to rest peacefully	an nghĩ
to reward	ban thưởng
to romanize	La Tinh hóa
to run at full speed	ba chân bốn cẳng
to run fast (vehicles)	bon bon
to rush at someone	a vào người nào
to sacrifice	bán lỗ
to screen	bao che
to sell	bán chác
to sell (crops) in ears (at cheap price)	bán non
to sell all of one’s belongings	bán hết nhà cửa
to sell at a low or reduced price	bán rẻ
to sell at a lower price	bán hạ giá
to sell for cash	bán tiền mặt
to sell goods	bán hàng
to sell in bulk	bán mớ
to sell on commission	buôn hàng xách
to sell on credit	bán chịu
to sell oneself	bán mình
to sell one’s country	bán nước
to sell one’s country down the river	buôn dân bán nước
to sell one’s soul	bán linh hồn
to sell one’s soul to the devil	bán linh hồn cho quỷ
to sell someone down the river	bán đứng
to sell well	bán chạy
to sell wholesale	bán buôn
to sell without the right of redeeming	bán đứt
to set sail; sail	buồm
to set up a ladder	bác than
to show	biểu hiện
to show enthusiasm	bày tỏ nhiệt tâm
to show or demonstrate a talent	biểu diễn tài nghệ
to show support	bày tỏ sự hậu thuẫn
to show the nature (of something)	biểu lộ bản chất
to sleep an endless sleep	an giấc nghìn thu
to sleep soundly	an giấc
to sleep the long sleep	an giấc ngàn thu
to smuggle	buôn lậu
to smuggle drugs	buôn lậu ma tuy
to sovietize	Sô Viết hóa
to speak ill of	báng (1) butt, stock (of a gun); (2) ascites; (3)
to specify	biệt định
to stammer	bi ba bi bô
to strain	bong gân
to such an extent	biết dường nào
to surround	bao quanh
to take one’s leave	bái biệt
to talk about	bàn đến
to tell stories	bày chuyện
to thank respectfully	bái tạ
to tie up at the corners	buộc túm
to trade	buôn
to trade from afar	buôn chuyến
to transcribe	biên chép
to transfer	bàn giao
to transfer an office	bàn giao chức vụ
to transform	biến dạng
to translate	biên dịch
to transliterate someone’s name into vietnamese	Việt hóa tên người
to treat very well	biệt đãi
to use disrespectful language	báng bổ
to vanish	bay biến
to vietnamize	Việt hóa
to vote on a law	biểu quyết luật
to vote unanimously	biểu quyết nhất trí
to want to defecate	buồn ỉa
to want to laugh; funny	buồn cười
to want to urinate	buồn đái
to yoke the oxen	buộc bò vào ách
tombstone	bia đá
tonnage	bài thủy lượng
tonsil	a mi đan
toothbrush	bàn chải răng
topcoat	bành tô
touching	bi cảm
towed target	bia kéo
track roller	bánh lăn đỡ
track wheels	bánh treo nâng
trade	bán chác
trade; to trade	buôn bán
traffic	buôn gian bán lận
traffic security	an ninh hệ thống liên lạc
tragedy	bi kịch
tragic	bi đát
tragic comedy	bi hài kịch
tranquil	an thân
tranquility	an tĩnh
tranquilizer; to tranquillize	an thần
transform	biến đổi
transformer	biến áp
translation	bài dịch
transmission security	an ninh truyền tin
transmutation	biến tính
traverse flying	bay hình chữ chi
tread on	bám riết
tree houses	ba nóc nhà
tremendous	bao la
tri-; (2) father; (3) wave	ba
tricycle	ba gác
trike	ba gác
trinity	ba ngôi
troop unit	binh đoàn
troops	binh lính
tropical almond	bàng
trung quốc	TQ
trách nhiệm hữu hạn	TNHH
turkey	Thổ Nhĩ Kỳ
turkish	Thổ Nhĩ Kỳ
turning table	bàn xoay
turntable	bàn quay
turtle	ba ba
twilight	buổi hoàng hôn
typhoid fever	ban chua
tây lịch	TL
tổng giám đốc	TGĐ
tổng thống	TT
u.s. supreme court	Tòa Tối Cao Hoa Kỳ
u.s.-vietnam	Mỹ-Việt
uncared-for	ba vạ
uncle	bá phụ
undecided	bán tín bán nghi
under arms	binh khí sẵn sàng
underdeveloped	bán khai
understand thoroughly; knowledgeable	am hiểu
undisciplined	ba lăng nhăng
undulate	ba động
undulating flying	bay đảo lên đảo xuống
unexpectedly	ai dè
unhappy	buồn bã
unhappy morose; uninteresting; to want to	buồn rầu
unharmed	an thân
united nations	Liên Hiệp Quốc
united states	Huê kỳ
united states of america; american	Huê Kỳ
unrestrained	buông thả
unusual talent	biệt tài
ups and downs	ba chìm bẩy nổi
uranus	Thiên vương tinh
us armed forces	Quân Độ Hoa Kỳ
us dollar	Mỹ Kim
usa	Mỹ
usis	Sở Thông Tin Hoa Kỳ
usom	Du Xom
usurp	bá chiếm
utter	buông lời
valiant	anh dũng
valuable lesson	bài học quý giá
vanish	biến mất
vanish; (2) to change	biến
variable	biến số
variance	biến tố
variant	biến thể
variation	biến tiết
vary	biến đổi
vast	bao la
vat)	GTGT
vatican; central building of a religion	Tòa Thánh
vc	Vi Xi
veda	Vệ Ðà
venus	Kim Tinh
very sad	buồn rượi
vientiane	Vạn Tượng
viet cong	Vi Xi
vietcombank	Ngân Hàng Thương Mại
vietminh	Việt Minh
vietnam	Việt Nam
vietnam bank for agriculture	Ngân Hàng Nông Nghiệp
vietnam economic times	Việt Nam kinh tế thời báo
vietnam of old	Việt Nam ngày xưa
vietnamese	Việt
vietnamese - chinese	Việt Hoa
vietnamese air force	Không Quân Việt Nam
vietnamese and russia alike	Việt Nam cũng như Nga
vietnamese as well as russian	Việt Nam cũng như Nga
vietnamese communists	Việt Cộng
vietnamese embassy	Sứ Quán Việt Nam
vietnamese king (1840-1883)	Tự Đức
vietnamese language	Việt ngữ
vietnamese new year’s festival	Tết Nguyên Đán
vietnamese news agency	Thông Tấn Xã Việt Nam
vietnamese resident	Việt kiều
vietnamese studies	Việt học
vietnamese version of the cinderella story	Tấm Cám
vietnamese-english	Việt-Anh
vietnamese-french	Việt-Pháp
vietnamization; to translate into vietnamese	Việt Nam hóa
villa	biệt thự
violence	biến động
visit	bái kiến
việt công	VC
việt nam	VN
việt nam công hoa	VNCH
vladivostok	Hải Sâm Uy
voice of america	Tiếng Nói Hoa Kỳ
voltage transformer	biến điện áp
volubly	bai bải
vote; a vote	biểu quyết
vs.	bài
waffle	bánh quế
walking	biết đi
want to sleep	buồn ngũ
war	binh hỏa
war situation	binh thế
warfare	binh hỏa
warsaw	Vacxava
washington	Hoa Thịnh Đốn
waste	buông quăng bỏ vãi
wavemeter	ba kế
way	bài
weapon	binh khí
wearing a dismal face from sadness	buồn rượi
welfare	an sinh
west	Tây
west germany	Tây Đức
west indies	Tây Ấn
western	Tây
western europe; the west	Tây Âu
western hemisphere	Tây bán cầu
western-brand (e.g. product)	Tây hiệu
what are you yawning for?	Ngáp gì?
what can we do	biết làm thế nào được
what can we use as evidence?	Lấy gì làm bằng?
when	bao giờ
whenever	bao giờ
which color do you like best?	anh thích màu nào hơn
white american	Mỹ trắng
who	Tổ Chức Y Tế Thế Giới
who (doesn’t)	ai chẳng
who can remember?	ai mà nhớ được
who else?	ai nữa
who is it? who goes there?	ai đấy
who is there?	ai đó?
who knows	biết đâu
who knows?	ai mà biết được
whoever	ai ai cũng đều
wholesale	bán sỉ
why?	Sao vậy?
wide-mouthed vase	ang
wide; (6) to reject	bác
widow	bà góa
wife	bà vợ
wife (one’s own)	bà xã
wife of an official	bà lớn
wipe out	bài trừ
wish for	ao ước
with certainty	biết chắc
with pain	ai phong
without a trace	biền biệt
without any opinion of one’s own; yes-man	ba phải
workplace	an toàn lao động
world bank	Ngân Hàng Thế Giới
world health organization	Tổ Chức Y Tế Thế Giới
world war ii	Trận Thế Chiến Thứ Nhất
world wide web	Liên Mạng Toàn Cầu
worthless	ba lăng nhăng
wrap	bao trùm
wrapping	bao bì
write	biên soạn
write down	biên chác
writer	biên tập viên
xenophobic	bài ngoại
yearn for	ao ước
yeast cake	bánh bò
yellow american	Mỹ vàng
yellow flag (rebels)	Cờ Vàng
yellow-colored wedding pastry	bánh su sê
yes sir	Vậng ạ
you are going too fast	anh đi mau quá
you ought to go to play	anh nên đi chơi
young male driver	anh tài xế
young man	anh chàng
younger brother	bào đệ
yugoslavia	Nam Tư
yunnan	Vân Nam
home	nhà
dog	con chó
